Second line: #rows, #columns, optional delay, optional map cell size. Other lines: O-omni switch, B-block of houses, H-horizontal switch, V-vertical switch, P-Western Power Company, C-Customer
20 20 
B B B B B B B B B B B B B B B B B B B B
B B P O B B B O O O B B B B O O B B B B
B B O B B B B B O B B B B O O B B O O B 
B O O H O O H H O B B B O B B B B O B B
B B V B B O O B B O B B O B B B B O B B
B B V B O H O H O V B O O B B B V B B B
B B O H O B V H H O B B O H B B B V B B
B B V B B B V B B O B O B O B B B O B B
B O O B O H O B B B O O B B O O O O B B
B V B B V B O B B B B B O B B B B B B B
B O O B H H O H H O O H H O O O O O O B
B H O H O B B B B O O O H H V B B B O B
B B B O B B B H O O B B B B O O B B O B
B B O O O B B O B V H C O O O V H O B B
B B O B B O O B B V B B B B B O B B B B
B B O B B O O B B V B B B B O V B B B B
B B O B B B O O B O H H O B O O O B B B
B O B B B B O B O B B B O O O B O B B B
B B O O O O O O O O B B O B B B B O B B
B B B B B B B B B B B B B B B B B B B B